111111111111111
100C0001C0000C1
1001000C10000C1
1001000000000C1
100001111011001
1P0011E00001CI1
111111111111111
