1111111111111111111111
1P000000000!00000000C1
1001111111C00011000001
1000!0000C110000110001
1000011111000000110001
10011C0000!00000110001
1000011111110000110001
1C000000000C00000000E1
1111111111111111111111
