111111111111111111111111111111111111111111
1010001111101110101000000000000C!110000011
101010111111101110000100000000110000000001
1000000P000000!00011111C011110000000000111
101110101110101011101100000000010000000001
1111111011000100010111000100000000C0011101
1000111000001010111011C1111101111000011111
101010101110000100101000C000000000!1110001
1110111010001000!000001111100000001C000011
1000C00C101010000000011100000C000000000001
101110101110101011101100000000010000000001
1111111011000100010111000100000000C0011101
1000111000001010111011C1111101111000011111
101010101110000100101000C000000000!1110001
1110111010001000!000001111100000001C000011
1000C00C101010000000011100000C000000000001
101110101110101011101100000000010000000001
1111111011000100010111000100000000C0011101
1000111000001010111011C1111101111000011111
101010101110000100101000C000000000!1110001
1110111010001000!000001111100000001C000011
1000C00C101010000000011100000C000000000001
101110101110101011101100000000010000000001
1111111011000100010111000100000000C0011101
1000111000001010111011C1111101111000011111
101010101110000100101000C000000000!1110001
1110111010001000!000001111100000001C000011
1000C00C101010000000011100000C000000000001
101110101110101011101100000000010000000001
1111111011000100010111000100000000C0011101
1000111000001010111011C1111101111000011111
101010101110000100101000C000000000!1110001
1110111010001000!000001111100000001C000011
1000C00C101010000000011100000C000000000001
101110101110101011101100000000010000000001
1111111011000100010111000100000000C0011101
1000111000001010111011C1111101111000011111
101010101110000100101000C000000000!1110001
1110111010001000!000001111100000001C000011
101110101110101011101100000000010000000001
1111111011000100010111000100000000C0011101
1000111000001010111011C1111101111000011111
101010101110000100101000C000000000!1110001
1110111010001000!000001111100000001C000011
1000C00C101010000000011100000C000000000001
101110101110101011101100000000010000000001
1111111011000100010111000100000000C0011101
1000111000001010111011C1111101111000011111
101010101110000100101000C000000000!1110001
1110111010001000!000001111100000001C000011
101110101110101011101100000000010000000001
1111111011000100010111000100000000C0011101
1000111000001010111011C1111101111000011111
1111111011000100010111000100000000C0011101
1000111000001010111011C1111101111000011111
101010101110000100101000C000000000!1110001
1110111010001000!000001111100000001C000011
101110101110101011101100000000010000000001
1111111011000100010111000100000000C0011101
1000111000001010111011C1111101111000011111
101010101110000100101000C000000000!1110001
1110111010001000!000001111100000001C000011
101010101110000100101000C000000000!1110001
101010101110000100101000C000000000!1110001
1110111010001000!000001111100000001C000011
101110101110101011101100000000010000000001
1111111011000100010111000100000000C0011101
101010101110000100101000C000000000!1110001
1000C00C101010000000011100000C000000000001
1111111011000100010111000100000000C0011101
1110111010001000!000001111100000001C000011
1110111010001000!000001111100000001C000011
1000C00C101010000000011100000C000000000001
101110101110101011101100000000010000000001
1111111011000100010111000100000000C0011101
101010101110000100101000C000000000!1110001
1110111010001000!000001111100000001C000011
1111111011000100010111000100000000C0011101
1000111000001010111011C1111101111000011111
101010101110000100101000C000000000!1110001
1110111010001000!000001111100000001C000011
1000C00C101010000000011100000C000000000001
101110101110101011101100000000010000000001
101010101110000100101000C000000000!1110001
1110111010001000!000001111100000001C000011
1000C00C101010000000E11100000C000000000001
111111111111111111111111111111111111111111
