1111111111111111111111111111111111111111111111111111111111111111111111111111111111
10100011111011101010000000000000000000000000000000000000000000000000000CC110000011
1010101111111011100001000000000000000000000000000000000000000000000000110000000001
1000000P0000000000000000000000000000000000000000000000C00011111C011110000000000111
1011101011101010000000000000000000000000000000000000000011101100000000010000000001
1111111011000100010111000100000000C00111000000000000000000000000000000000000000001
1000111000001010111011C11111011110000000000000000000000000000000000000000000011111
1010000000000000000000000000000000000000000010101110000100101000C000000000C1110001
11101110100000000000000000000000000000000000000000001000C000001111100000001C000011
10000000000000000000000000000000000000000000C00C101010000000011100000C000000000001
1011101011100000000000000000000000000000000000000000101011101100000000010000000001
11111110110000000000000000000000000000000000000000000100010111000100000000C0011101
10001110000000000000000000000000000000000000000000001010111011C1111101111000011111
1010101011100000000000000000000000000000000000000000000100101000C000000000C1110001
1110111010001000C000001111100000001C0000000000000000000000000000000000000000000011
1000C00C101010000000011100000C0000000000000000000000000000000000000000000000000001
1011101011101000000000000000000000000000000000000000001011101100000000010000000001
1111111011000100010111000100000000C00111000000000000000000000000000000000000000001
1000111000001010111011C11111011110000000000000000000000000000000000000000000011111
101010101110000100101000C0000000000000000000000000000000000000000000000000C1110001
11101110100010000000000000000000000000000000000000000000C000001111100000001C000011
1000C00C1010100000000000000000000000000000000000000000000000011100000C000000000001
1011101011101010111011000000000100000000000000000000000000000000000000000000000001
1111111011000100010111000100000000C00000000000000000000000000000000000000000011101
10001110000010101110000000000000000000000000000000000000000011C1111101111000011111
1010101011100001001010000000000000000000000000000000000000000000C000000000C1110001
1110111010001000C0000000000000000000000000000000000000000000001111100000001C000011
1000C00C1010100000000000000000000000000000000000000000000000011100000C000000000001
1000000000000000000000000000000000000000001110101110101011101100000000010000000001
1111111011000100010111000100000000C00111000000000000000000000000000000000000000001
10001110000010101110000000000000000000000000000000000000000011C1111101111000011111
1010101011100001000000000000000000000000000000000000000000101000C000000000C1110001
1110111010001000C0000011100000000000000000000000000000000000000001100000001C000011
1000C00C0000000000000000000000000000000000000000101010000000011100000C000000000001
1011101011101010111011000000000000000000000000000000000000000000000000010000000001
11111110100000000000000000000000000000000000000001000100010111000100000000C0011101
10001110000000000000000000000000000000000000000000001010111011C1111101111000011111
101010101110000100101000C0000000000000000000000000000000000000000000000000C1110001
11101110100000000000000000000000000000000000000000001000C000001111100000001C000011
1011101011101010111011000000000000000000000000000000000000000000000000010000000001
11111110000000000000000000000000000000000000000011000100010111000100000000C0011101
10001110000000000000000000000000000000000000000000001010111011C1111101111000011111
1010101000000000000000000000000000000000000000001110000100101000C000000000C1110001
1110111010001000C0000011111000000000000000000000000000000000000000000000001C000011
1000C000000000000000000000000000000000000000000C101010000000011100000C000000000001
1011100000000000000000000000000000000000000000101110101011101100000000010000000001
11111110110001000101110001000000000000000000000000000000000000000000000000C0011101
10001110000010000000000000000000000000000000000001000110111011C1111101111000011111
1010101011100001000000000000000000000000000000000000010000101000C000000000C1110001
1110111010001000C000001111100000001C0000100000000000000000000000000000000000010001
1011101011101010000000000000000000000000000000000000100011101100000000010000000001
11111110110001000000000000000000000000000000000000001000010111000100000000C0011101
10001110000000000000000000000000000000000000001000001010111011C1111101111000011111
11111110110000000000000000000000000000000000000010000100010111000100000000C0011101
10001110000000000000000000000000000000000000001000001010111011C1111101111000011111
101010101110000100101000C000000000C11100000000000000000000000000000000000000100001
11101110100000000000000000000000000000000000000100001000C000001111100000001C000011
1011101011101010111011000000000100000000000000000000000000000000000000000001000001
11111110110001000101110001000000000000000000000000000000000000001000000000C0011101
1000111000001010111011C11111011110000111000000000000000000000000000000000000100011
101010101110000100101000C0000000000000000000000000000000000000000001000000C1110001
1110111010001000C000001111100000001C0000100000000000000000000000000000000000010001
101010101110000100101000C0000000000000000000000000000000000000000010000000C1110001
1010101011100000000000000000000000000000000000000001000100101000C000000000C1110001
1110111010001000C000001111100000001C0000100000000000000000000000000000000000010001
1011101011101010111011000000000100000000000000000000000000000000000000000010000001
11111110110000000000000000000000000000000000000001000100010111000100000000C0011101
101010101110000100101000C0000000000000000000000000000000000000000010000000C1110001
1000C00C1010100000000110000000000000000000000000000000000001000100000C000000000001
11111110110001000101100000000000000000000000000000000000010001000100000000C0011101
1110111010001000C0000000000000000000000000000000000001000000001111100000001C000011
1110111010001000C0000011111000000000000000000000000000000000000000100000001C000011
1000C00C1010100000000000000000000000000000000000000000100000011100000C000000000001
1011101011101010110000000000000000000000000000000000001000101100000000010000000001
11111110110001000101110001000000000000000000000000000000000000000000100000C0011101
1010101011100001001000000000000000000000000000000000000100001000C000000000C1110001
1110111010001000C0000011111000000000000000000000000000000000000000001000001C000011
11111110100000000000000000000000000000000000010001000100010111000100000000C0011101
10001110000000000000000000000000000000000000100000001010111011C1111101111000011111
1010101011100000000000000000000000000000000000010000000100101000C000000000C1110001
1110111010001000C0000011111000000000000000000000000000000000000001000000001C000011
1000C00C1010000000000000000000000000000000000001000010000000011100000C000000000001
1011101011101010111011000000000000000000000000000000000000001000000000010000000001
1010101011100001001010000000000000000000000000000000000000001000C000000000C1110001
1110111010001000C0000011110000000000000000000000000000000000001000100000001C000011
1000C00C101010000000E000000000000000000000000000000000000100011100000C000000000001
1111111111111111111111111111111111111111111111111111111111111111111111111111111111
