1111111111111
1001S0100!011
1000011111001
1P0011E00E001
1111111111111