1111111110111
10010000000C1
10000111110E1
1P0011C000001
1111111111111
