1111111111111111
1P000000000000!1
1!11111111111C01
11!1111111111101
1!C0000000000001
10011111111111!1
10!1111111111111
1C000000000000C1
1!11111111111!01
111111111111!C01
1E000000000000!1
1111111111111111