1111111111111111
1P00000000000011
1111111111111C01
1111111111111101
11C0000000000001
1001111111111111
1011111111111111
1C000000000000C1
1111111111111101
1111111111111C01
1E00000000000011
1111111111111111