1111111111111111
1P000000000000!1
1!1111111111!C01
111110C0!0C01101
1!C0001000100001
1001111111!!11!1
1!C10C0!10CC!111
1C00010000!000C1
1!11111111!11!01
1111111!CCC1!C01
1E0000000!0000!1
1111111111111111