1111111111111111
1P000000000000!1
1!1111111111!C01
111110C0!0C01101
1!C0001000100001
100111111!!!11!1
10!10C0!10CC!111
1C000!0000!000C1
1!11111111111!01
111111111111!C01
1E000000000000!1
1111111111111111