11111111111111111111111111111111
1P000000000000000000000000000001
11111111111111111111111111111101
11111111111111111111111111111101
11C00000000000000000000000000001
10011111111111111111111111111111
10111111111111111111111111111111
1C000000000000000000000000000001
11111111111111111111111111111101
11111111111111111111111111111101
10000000000000000000000000000001
10111111111111111111111111111111
10111111111111111111111111111111
10000000000000000000000000000001
11111111111111111111111111111101
11111111111111111111111111111101
11C00000000000000000000000000001
10011111111111111111111111111111
10111111111111111111111111111111
1C0000000000000000000000000000C1
11111111111111111111111111111101
11111111111111111111111111111101
1E000000000000000000000000000001
11111111111111111111111111111111