111111
1C!0E1
1C0CC1
1PCC01
111111