111111111111111
100P0001C0000C1
1001000C10000C1
100100000C000C1
1000011110110C1
100011E00001C11
111111111111111
